###################
#................@#
#..###..###..#..#.#
#.##...###...#....#
#.#...###..##..#..#
#.....##..##....#.#
#.###.#..##..####.#
#.###...##..#####.#
#.####..##.######.#
#.#####......####.#
#.#####..#.#.####.#
#.####..#..#..###.#
#.###..##.###.###.#
#.##..##..###.....#
#.#..###.####...#.#
#...###..##...###.#
#.#..##.##...###..#
#.................#
###################