############
#...b......#
#.@#.....#.#
#.##.....###
#b.........#
#...#...#..#
#.....#....#
#....###...#
#.....#....#
#...#...#..#
#.........r#
#.##.....###
#..#...r..@#
############