############
#..........#
#.@#.....#.#
#.##.....###
#..........#
#...#...#..#
#.....#....#
#....###...#
#.....#....#
#...#...#..#
#..........#
#.##.....###
#..#......@#
############